XXXXXXXXXXXXXXXX
XSX0X0000000XX0X
X0X000XXXXX0X00X
X0X0X0XXXX00X0XX
X0X0X0X00000000X
X000X0X0X0XXXXXX
X0X0X0X0X000000X
X0X0XXX0X0XXXXXX
X0X000X00000000X
X0X0X0X0XXXXX00X
XXX0XXX0X000000X
X000X000X0XXXXXX
X0XXX0X0X000000X
X0X000XXXXX0XX0X
X0000XX000000XGX
XXXXXXXXXXXXXXXX