XXXXXXXXXXXXXXXXXXXXXXXXXXXXXXXXXXXX
X0000000000000000000000000000000000X
X0000000000000000000000000000000000X
X0000000000000000000000000000000000X
X00000000000XX0000000XX000000000000X
X0000000000X00X00000X00X00000000000X
X0000000000000000000000000000000000X
X0000000000000000000000000000000000X
X0000000000000000000000000000000000X
X0000000000000000000000000000000000X
X0000000000000000000000000000000000X
X0000000000X0000000000X000000000000X
X00000000000X00000000X0000000000000X
X000000000000XXXXXXXX00000000000000X
X0000000000000000000000000000000000X
X0000000000000000000000000000000000X
X0000000000000000000000000000000000X
X0000000000000000000000000000000000X
X0000000000000000000000000000000000X
X0000000000000000000000000000000000X
X00XXX00000XXX000XX00000X0XXXX0X000X
X00X00X000X000X00X0X0000X0X0000X000X
X00X000X0X00000X0X00X000X0XXXX0X000X
X00X000X0X00000X0X000X00X0X0000X000X
X00X00X000X000X00X0000X0X0X00000000X
X00XXX00000XXX000X00000XX0XXXX0X000X
X0000000000000000000000000000000000X
X0000000000000000000000000000000000X
XXXXXXXXXXXXXXXXXXXXXXXXXXXXXXXXXXXX